1111111111111111111111111111111111
1E00000000000000000000000000000001
101001010010000C1010010000W0010101
1010010010101010001001000000010101
1P000000000000000W000000W000000001
1111111111111111111111111111111111